ID,Infection,Movement,Stiffness,Window
1,0,0,0,2
2,0,0,0,2
3,0,0,0,2
4,0,0,0,2
5,0,1,1,1
6,0,1,0,1
7,0,0,0,1
8,0,1,0,1
9,0,0,0,3
10,0,0,0,3
11,0,1,0,3
12,0,1,0,3
13,1,0,0,4
14,0,0,1,4
15,1,0,0,4
16,1,0,0,4
17,0,0,0,5
18,0,0,0,5
19,0,0,0,5
20,0,0,0,5
21,0,0,0,3
22,0,0,0,3
23,0,0,1,3
24,0,0,0,3
25,0,0,0,2
26,0,0,0,2
27,0,0,0,2
28,0,0,0,2
